Jag ser uppgivet på mig själv i spegeln.	I look despondently at myself in the mirror.
Fan ta mitt hår.	Devil take my hair.
Jag borde plugga inför sluttentorna nästa vecka.	I should study for finals next week.
Jag får inte gå och lägga mig med fuktigt hår.	I should not go to bed with wet hair.
Sedan ger jag upp.	Then I give up.
Och jag fick rycka in.	And I got to help out.
Det tog mig tio månader att fixa den här intervjun.	It took me 10 months to fix this interview.
Du borde gå och lägga dig igen.	You should go to bed again.
Tryck bara på knappen som det står 'rec' på.	Just push the butten that says 'rec' on it.
Jag vet ju ingenting om honom.	I know nothing about him.
Jag tar upp min väska...	I take my bag...
Jag ska till företagets huvudkontor.	I go to the companies head office.
Vill du vara så vänlig att vänta där borta?	Would you be so kind as to wait over there?
Du milde.	My goodness.
Jag sätter mig och tar fram frågorna ur väskan.	I sit and retrieve the questions out of the bag.
Osäkerheten gör mig nervös och jag skruvar oroligt på mig.	Uncertainty makes me nervous and I turn uneasily.
Han tar emot dig om en stund.	He receives you in a moment.
Har du fått nåt att dricka?	Have you received something to drink?
Föredrar ni te, kaffe eller vatten?	Do you prefer tea, coffee or water?
Jag är inte van vid det här.	I am not used to this.
Jag borde ersätta dig för klädderna.	I should pay you back for the clothes.
Du borde faktiskt lära dig att ta emot en komplimang.	You should actually learn to take a compliment.
Då får väl du berätta det för mig.	Then you will have to tell me.
Du har gott om tid.	You have plenty of time.
Det handlar inte om det.	It isn't about that.
Det måste vara det sexigaste någon har sagt till mig någonsin.	That must be the sexiest thing someone has said to me ever.
Jag fattar inte att jag sa det där sista högt.	I can't believe I said that last thing out loud.
Hej allihopa! Förlåt att jag är sen.	Hi everyone! Sorry I'm late.
Den högröstade minoriteten representerar inte majoriteten i de flesta fallen.	The vocal minority do not represent the majority in most cases.
Det är nyttigt med bananer.	Bananas are good for you.
Var ligger den närmaste marknaden?	Where is the nearest market?
En expert kan stämma en violin på gehör.	An expert can tune a violin by ear.
Kamouflage är naturens bästa knep.	Camouflage is nature's best trick.
Kostnaderna är höga och intäkterna låga. Vad kan man göra?	Costs are up, revenue is down. What can you do?
Du kan inte skylla dina problem på andra.	You can't blame other people for your problems.
Fyrverkerier lyste upp kvällshimlen.	Fireworks lit the night sky.
Internet har förändrat våra liv, på gott och på ont.	The internet has changed our lives, for good or bad.
Min farfar kan hundratals anekdoter.	My grandfather knows hundreds of anecdotes.
Hur många veckor ska det här projektet ta?	How many weeks does this project have to take?
Ett verb är ett ord som uttrycker en handling eller ett skeende.	A verb is an word that expresses action or occurrence.
Jag förstår inte. Kan du upprepa det?	I don't understand. Can you repeat that?
Problemet med silver är att det oxiderar så lätt.	The problem with silver is that it tarnishes so easily.
Om Sfinxen ställer en gåta, är det bäst att du vet svaret.	If the Sphinx asks you a riddle, you better know the answer.
Varje höst börjar ett nytt läsår.	Every fall, the school year begins anew.
Du har mycket att lära dig, gräshoppan.	You have much to learn, grasshopper.
Han samlar på affischer av gamla skräckfilmer.	He collects posters of old horror movies.
Hur vågar du använda sådant språk i det här huset?!	How dare you use such language in this house?!
Sitt upp! Dålig hållning leder till senare ryggproblem.	Sit up! Bad posture will lead to back problems later on.
Om du är arg, ta ett djupt andetag och räkna till tio.	If you're angry, take a deep breath and count to ten.
Kostnaderna är höga och intäkterna låga. Vad kan man göra?	Costs are up, revenue is down. What can you do?
Att stirra in i solen orsakar blindhet!	Staring at the sun causes blindness!
Klockan är tio. Vet du var dina barn är?	It's 10 o'clock. Do you know where your kids are?
Vad fan har du på dig?!	What the heck are you wearing?!
Gör inte det! Det är en dålig idé!	Don't do that! It's a bad idea!
Rädslan för att flytta eller att genomgå förändring kallas tropofobi.	The fear of moving or making changes is called tropophobia.
Räck mig kikaren, är du snäll.	Please pass me the binoculars.
Jorden är täckt mest av vatten.	The Earth is covered mostly by water.
På höga höjder finns det mindre syre i luften.	At high elevations, there is less oxygen in the air.
Två bullriga gäss bor nära dammen.	Two noisy geese live near the pond.
Jag har ätit så mycket att jag knappt kan knäppa byxorna!	I ate so much I can barely button my pants!
Om jag berättar för dig, kommer det inte att vara en hemlighet längre!	If I tell you, it won't be a secret anymore!
Om vi inte skyndar oss, kommer vi att missa bussen.	If we don't hurry, we'll miss the bus.
Trädgårdar behöver bra jordmån, sol, och regelbunden vattning.	Gardens need good soil, sun, and regular watering.
Vi uppträdde på vår lokala teater.	We performed in our community theater.
Var parkerade du bilen?	Where did you park the car?
Jag lärde mig det genom att kolla på dig, Pappa!	I learned it from watching you, Dad!
Igår kungjorde de sin förlovning.	Yesterday they announced their engagement.
Jag värmer vatten i vattenkokaren.	I'm warming water in the kettle.
Dina stövlar står framför dörren.	Your boots are in front of the door.
Räkna tegelstenarna i väggen om du har tråkigt.	Count the bricks in the wall if you're bored.
Hon behöver borsta håret.	She needs to brush her hair.
Vi brände maten av misstag.	We accidentally burned the food.
Deras hästar bor i stallet.	Their horses live in the stable.
Ta med er champagne, vi står för jordgubbarna.	Bring champagne, we'll supply the strawberries.
Jag medger att det är ett attraktivt erbjudande.	I admit, it is an attractive offer.
Vår chef behandlar oss artigt.	Our boss treats us courteously.
Jag tittade, och framför mig stod en blek häst!	I looked, and before me was a pale horse!
De säljer söt äppelcider.	They sell sweet apple cider.
Jag gjorde ett fotoalbum från vår senaste semester.	I made a photo album of our last vacation.
Cigarrer är en av Kubas största exportvaror.	Cigars are one of Cuba's largest exports.
Den unga flickan kramade om sin nallebjörn.	The young girl hugged her teddy bear.
Kan du recitera den gamla dikten?	Can you recite the old poem?
Snälla svara på frågan ärligt.	Please answer the question honestly.
Jag har varit hos tandläkaren tusen gånger, så jag vet hur det går till.	I've been to the dentist a thousand times, so I know the drill.
Konstnären ritade en utmärkt figur.	The artist drew an excellent figure.
Skada inte paketet.	Do not damage the package.
Vilken skillnad en dag kan göra!	What a difference a day makes!
Då delar vi upp tårtan i lika stora bitar.	Let's divide the cake into equal parts.
Vad gav du henne i födelsedagspresent?	What did you give her for her birthday?
Jag tvivlar på att måtten är precisa.	I doubt the accuracy of the measurements.
Du kan duscha i badrummet på övervåningen.	You can shower in the bathroom upstairs.
Förklara lösningen för mig en gång till.	Explain the solution to me one more time.
Våra traditioner måste verka främmande för dig.	Our customs must seem alien to you.
Kan du ge mig ett exempel på vad du menar?	Can you give me an example of what you mean?
Vilket kort ska jag välja?	Which card should I choose?
Efter en lång promenad, är hennes hund energisk.	Even after a long walk, her puppy is energetic.
Hans fall handlade om misstagen identitet.	His was a case of mistaken identity.
Det finns undantag till varje regel.	There are exceptions to every rule.
Det sägs att spöken hemsöker det gamla huset.	They say that ghosts haunt the old house.
Har du läst ut boken?	Have you finished the book?
Träden kommer att blomma om några veckor.	The trees will flower in a few weeks.
Den filmen var inte alls läskig.	That movie wasn't scary at all.
Jag hör honom komma; jag föreslår att vi drar oss tillbaka, min herre.	I hear him coming: let's withdraw, my lord.
Gräv tills du hittar olja.	Dig until you strike oil.
Fossilerna på museet är från kritaperioden.	The fossils at the museum are from the Cretaceous period.
Hon fotograferade en ovanlig fågel.	She photographed a rare bird.
Vilken kylig dag!	What a chilly day!
Vi väntar på bussen.	We are waiting for the bus.
Barnen åker skridskor på dammen när den är helt fryst.	The children ice-skate on the pond once it is frozen solid.
Hans morfar gav honom en pulka i vintras.	His grandfather gave him a sled last winter.
Min hals gör ont idag.	My throat is hurting today
Min bror tar studenten om en månad.	My brother will graduate in a month.
Gräsklipparen behöver bensin.	The lawnmower needs gasoline.
Det fanns en grön äng nedanför klippan.	There was a green meadow below the cliff.
De studerade historia vid universitetet.	They studied history at the university.
För trettio år sedan slog blixten ner i det där klocktornet.	Thirty years ago, lightning struck that clock tower.
Hur kommer man till sjukhuset?	Which way is the hospital?
Skådespelarna improviserade hela scenen.	The actors improvised the entire scene.
Hennes hem är fint inrett, som vanligt.	Her house is, as usual, very well decorated.
Du kommer att behöva en större båt.	You're going to need a bigger boat.
Meddelandet har kanske råkat hamna i din mapp för skräppost.	The email may have accidentally gone into your junk mail folder.
Varför blockerade du mig på Twitter, vännen?	Why'd you block me on Twitter, friend?
Tålamod är en dygd.	Patience is a virtue.
Jag vågar inte fråga henne en tredje gång.	I don't dare to ask her a third time.
Jag har varit uppe hela natten och pluggat inför det här provet.	I've been up all night studying for this test.
Skruva ner volymen, jag får huvudvärk.	   Turn down the volume, I'm getting a headache.
Om löken är för stor, använd bara halva.	If the onion is too big, use only half of it.
Vill du ha pommes frites till?	Do you want fries with that?
Hon och jag ska gå till stranden imorgon.	She and I will go to the beach tomorrow.
Såg skogsmurmeldjuret sin skugga?	Did the groundhog see his shadow?
Vill du fotvandra genom skogen?	Do you want to hike through the woods?
Jag fick aldrig bra betyg i matematik.	I never received good grades in mathematics.
En bilmekaniker reparerade vår bil.	A mechanic fixed our car.
Du har ett öppet sinne.	You have an open mind.
Jag kan inte bestämma mig. Ska vi singla slant?	I can't make up my mind. Shall we flip a coin?
Ingen verkar ha tillräckligt med pengar.	Nobody seems to have enough money.
Men man fick ställa in konserten	But they had to cancel the concert
I USA tycker de flesta människor inte att Snowden är en förrädare	In the USA many people do not think that Snowden is a traitor
Min hund kommer inte att bita dig.	My dog will not bite you.
Myggorna vill inte lämna mig i fred!	The mosquitoes will not leave me alone!
Vem är din favoritfilmstjärna?	Who's your favorite movie star?
Jag älskar skaldjur men min kompis är allergisk mot det.	I love seafood, but my friend is allergic to it
Ibland gillar jag att bara sätta mig med en bra bok.	Sometimes I just like to sit down with a good book.
Bort från min gräsmatta!	Get off my lawn!
Det är lättare att be om förlåtelse än om tillåtelse.	It's easier to ask forgiveness than permission.
Min granne är gift med sin syssling.	My neighbor married her second cousin.
Hennes hår ser jättebra ut i flätor.	Her hair looks really good in braids.
Du kompletterar mig.	You complete me.
Fordonets passagerare blev inte skadad.	The passenger of the vehicle was unharmed.
Idag hade museet en intressant utställning om indisk folkmusik.	The museum had an interesting exhibit about Indian folk music today.
Få inte panik, det är bara en brandövning.	Don't panic, it's only a fire drill.
När hon såg mig, pussade hon mig två gånger på kinderna.	When she saw me, she kissed me twice on the cheeks.
Man ska dricka mycket vatten när man är förstoppad.	You have to drink a lot of water when you're constipated.
Annika föredrar fläsk framför nötkött.	Annika prefers pork to beef.
I natt drömde jag att jag flöt bland molnen.	Last night I dreamt I was floating amongst the clouds.
Branden spreds inte eftersom sprinklerna var aktiverade.	The fire did not spread because the sprinklers were activated.
Under vår resa runt i England, besökte vi klipporna i Dover.	During our trip around England we visited the cliffs of Dover.
Ska vi vila bredvid den där busken därborta?	Should we rest beside that bush over there?
Ring mig ikväll, så gör vi planer.	Call me tonight and we'll make plans.
Kvinnan på flygplatsen kontrollerade våra boardingkort.	The woman at the airport checked for our boarding passes.
Låt mig ge dig ett tips.	Let me give you a hint.
Programmet har ett lättanvänt gränssnitt.	The program has an easy-to-use user interface.
Nästa år är ett skottår.	Next year is a leap year.
Såg du rubrikerna i morse?	Did you see the headlines this morning?
Ni ska lämna in era rapporter på måndag morgon.	You are to hand in your reports on Monday morning.
Vintersnön har redan smält.	The winter snow has already melted.
Första utkastet är färdigt imorgon.	The first draft will be ready by tomorrow.
Det kryper en tusenfoting i badkaret!	There is a centipede in the bathtub!
Man måste tina upp kalkonen innan man lägger in den i ugnen.	You have to defrost the turkey before putting it in the oven.
Min farbror har en segelbåt ute på sjön.	My uncle has a sailboat out on the lake.
Jag håller med dig om det.	I agree with you on that issue.
Man får inte köra om på den här vägsträckan.	You can't pass on this stretch of road.
Vi valde en plats på måfå.	We chose a seat at random.
Jag menade inte att förolämpa dig.	I didn't mean to offend you.
Den bilhandlaren har inte modellen jag letar efter.	That car dealership doesn't have the model I'm looking for.
Han ser lite illvillig ut med getskägg.	He looks kind of sinister with a goatee.
Visa mig pengarna!	Show me the money!
Polisen hittade två lik på brottsplatsen.	The police found two corpses at the scene of the crime.
På huvudmenyn väljer du "inställningar".	On the main menu, select "options".
Svarta katter betyder otur.	Black cats are a sign of bad luck.
Alkohol kan vara farligt för levern.	Alcohol can be harmful to the liver.
Sätt dig ner, så brygger jag lite te.	Sit down and I'll brew some tea.
Slaktaren gav mig den här steken gratis.	The butcher gave me this steak for free.
Det fungerade i filmen!	It worked in the movie!
Någon har ristat in sitt namn i barken på det där trädet.	Someone carved their name into the bark of that tree.
Torkad frukt är rik på proteiner.	Dried fruit is rich in protein.
Jag vill bli författare när jag blir stor.	I want to be a writer when I grow up.
Jag är två drag ifrån schackmatt.	I'm two moves away from a check-mate.
Jag gillar flingor när de fortfarande är krispiga.	I like cereal when it's still crispy.
Han skrev manuset till sin senaste film själv.	He wrote the script for his latest movie himself.
Tsunamin var förödande.	The tsunami was devastating.
De flesta internetanvändarna förväntar sig hög anslutningshastighet.	Most internet users expect high connection speeds.
Du passar inte i dreadlocks.	Dreadlocks don't look good on you.
Inspelningen av olyckan var chockerande.	The footage of the accident was shocking.
Den rika affärsmannen klagade på att lasagnen var smaklös.	The rich businessman complained that the lasagna was tasteless.
Han har alltid varit vid min sida.	He has always been by my side.
Pilen träffade mitt i målet.	The arrow hit the center of the target.
Jag får alltid kakor av min mamma till julen.	My mother always gives me cookies on Christmas.
Jag skulle aldrig i livet vilja kolla på den filmen.	I wouldn't watch that movie in a million years.
Jag älskar doften av din nya luftfräschare.	I love the scent of your new air freshener.
Vi måste göra oss av med våra gamla möbler.	We have to get rid of our old furniture.
Ingen smärta, ingen vinst.	No pain, no gain.
Riddaren blockerade slaget med sin sköld.	The knight blocked the blow with his shield.
Efter spelet, skakade jag hand med min motståndare.	After the game, I shook hands with my opponent.
Jag kan gå och tugga tuggummi samtidigt.	I can walk and chew gum at the same time.
Jag köpte inte den nyaste modellen för den är så dyr.	I didn't buy the most recent model because it's so expensive.
Det svenska tangentbordet har flera tangenter som inte finns på det amerikanska.	The Swedish keyboard has several keys that aren't on the American.
Ett äpple om dagen håller doktorn borta.	An apple a day keeps the doctor away.
Det här är sista gången jag kommer att varna dig.	That's the last time I'm going to warn you.
Hälsa är bättre än rikedom.	Health is better than wealth.
Skratt är den bästa medicinen.	Laughter is the best medicine.
Minns du kvällarna vi tillbringade under stjärnorna?	Do you remember the evenings we spent under the stars?
Jag har spillt min dricka, så jag kommer behöva fler servetter.	I spilled my drink, so I'm going to need more napkins.
Låt dig inte ryckas med av ilska.	Don't get carried away by anger.
Att fela är mänskligt, att förlåta gudomligt.	To err is human, to forgive divine.
Dina dåliga sömnvanor kan vara en källa till stress.	Your bad sleeping habits may be a source of stress.
Vi håller just nu på och målar väggarna i mitt rum.	We're currently painting the walls of my room.
Det är som att prata med en vägg.	It's like talking to a wall.
Ingen rök utan eld.	Where there's smoke, there's fire.
Vi är alla lite galna på ett eller annat sätt.	We're all a little crazy in one way or another.
Jag fick inte en blund i ögonen hela natten eftersom grannen spelade sådan hög musik.	I didn't sleep a wink all night since my neighbor was playing such loud music.
Det kanske går att fixa med lim.	You might be able to fix it with glue.
Min arga svägerska gav mig en blåtira häromdagen.	My angry sister-in-law gave me a black eye the other day.
Vi stannade hos en kompis när flyget blev inställt.	We stayed at a friend's place when the flight was canceled.
Jag behöver den egentligen inte men den är på rea!	I don't really need it, but it's on sale!
Slagsmålsscenen såg väldigt grotesk ut.	The fight scene looked quite grotesque.
"Okej, jag gör det" mumlade John.	"Fine, I'll do it," mumbled John
Det kostar tio kronor att fylla på din dricka.	It costs 10 crowns to refill your drink.
Är du medveten om att din kollega har hållit på och försnillat pengar?	Are you aware that your colleague has been embezzling money?
Ljudet av explosionen skrämde mig.	The sound of the explosion startled me.
De har hållit på och grälat hela kvällen.	They have been quarreling all evening.
Han är ett bortskämt barn.	He is a spoiled child.
Jag är herre över mitt eget öde.	I am the master of my own destiny.
Han gjorde åtminstone något; alla andra bara såg på.	At least he did something; everyone else just watched.
Man ska inte svära här.	One shouldn't use profanity here.
Ni får fortsätta med projektet under min frånvaro.	You can keep the project going in my absence.
Vi planerade en överraskningsfest i hemlighet.	We planned a surprise party in secret.
Mamma, jag vill åka pariserhjulet!	Mom, I want to go on the Ferris wheel!
Han kunde inte komma över tragedin i att hans hus hade brunnit ner.	He could not overcome the tragedy of his house burning down.
Jag köper alltid kärnfri vattenmelon.	I always buy seedless watermelon.
Invände inte din pappa den här gången?	Didn't your father object this time?
Min dotter arbetar som flygvärdinna.	My daughter works as a stewardess.
Basilika är huvudingrediensen i pesto.	Basil is the main ingredient in pesto.
Jag kommer dit så snart jag kan.	I will be there as soon as I can.
Förtäring av mat och dryck är förbjudet i det här rummet.	Consumption of food and drink is forbidden in this room.
Min katt blev ursinnig när bilen började röra sig.	My cat became frantic when the car began to move.
Vi segrade över fienderna med hjälp av våra kompisar.	We defeated the enemies with the help of our friends.
Det kanske är en slum, men det är ändå hemma.	It may be a slum, but it's still home.
Jag saknar att ha en trädgård.	I miss having a garden.
Han sover inte om inte man läser för honom.	He won't go to sleep unless you read him a story.
Jag längtar hem eftersom jag bor utomlands.	I feel longing for my home because I'm living abroad.
Jag älskar att höra vinden viska genom träden.	I love to hear the wind whisper through the trees.
Vi sov i det fria, under stjärnorna.	We slept in the open, under the stars.
Alla mina kompisar kommer! Jag hoppas det!	All my friends will come! I hope so!
Vad säger du om en blindträff via webbkamera?	What do you think about a blind date by webcam?
Det är okej att dricka, så länge man inte dricker för mycket.	Drinking is OK as long as you don't do it in excess.
Var så god, vidarebefordra alla frågor till borgmästaren.	Please forward all questions to the mayor.
Mitt liv är en enda röra och jag vet inte vad jag ska göra.	My life is a mess and I don't know what to do.
Att lägga pussel är bra för hjärnan.	Putting jigsaw puzzles together is good for the brain.
Provet avslöjade studenternas brist på förberedelse.	With the exam the students revealed a lack of preparation.
Han bara gjorde det för att briljera för sina kompisar.	He did it just to show off in front of his friends.
Han märkte inte av min ironi.	He didn't notice my irony.
Du gör mig så lycklig!	You make me so happy!
Han studerade vid musikhögskolan i Wien.	He studied at the music academy in Vienna.
Vetenskapsmän är oroade över växthuseffekten.	Scientists worry about the Greenhouse Effect.
Han misslyckades med sitt försök att slå världsrekordet.	He failed in his attempt to beat the world record.
Vi hade en diskussion om pengar.	We had an argument about money.
Den sjätte punkten på dagordningen verkar väldigt intressant.	The sixth item on the agenda looks very interesting.
Läkaren gav henne råd om hur hon skulle ta hand om sin bebis.	The doctor advised her how to take care of her baby.
Hans bror jobbar som frisör i Göteborg.	His brother works as a barber in Gothenburg.
Nu vill jag presentera vår nästa talare, herr Jordan Chase.	I'd like to introduce our next speaker, Mr. Jordan Chase.
Majoriteten av befolkningen är utblottad.	The majority of the population is destitute
Hennes version av händelserna passar inte ihop med hans.	Her versions of the events does not match up with his.
Jag brukade campa som barn.	I used to go camping as a child.
När det slutar regna, ska vi gå på promenad.	When it stops raining we will go for a walk.
Jag struntar i hur rummet ser ut, såvida det är städat.	I don't care how the room looks as long as it is clean.
Jag kan inte bli sjuk nu, min semester börjar imorgon!	I can't get sick now, my vacation time starts tomorrow!
Absolut, jag håller med alla som säger det.	Certainly, I agree with all those who say that.
Tror du att du kan lura mig? Tänk dig för!	Do you think you can cheat me? Think again!
Det här är ett vackert land.	This is a beautiful country
Jag gillar Svarta havets vågor.	I like the waves of the Black Sea.
Han lurar oss alltid; jag litar inte på honom.	He always deceives us; I don't trust him.
Han är en sådan tråkig lärare.	He is such a bore of a teacher.
Polisen grep en ficktjuv igår.	The police arrested a pick-pocket last night.
Mat verkar smaklös när man är förkyld.	Food seems tasteless when one has a cold.
Jag är inte på humör för skämt.	I'm not in the mood for jokes.
Håll i det här fiskespöet en stund.	Hold this fishing pole a moment.
Jag måste gå nu, men vi ses snart!	I've got to go now, see you soon!
Natten därpå sov jag som en stock och jag hörde ingenting.	That night I slept like a log and I didn't hear anything.
Artikeln om ekonomi visade sig vara användbar för min forskning.	The article on economics proved useful for my research.
Min brorson gillar historier med troll och älvor.	My nephew likes stories with trolls/goblins and fairies.
Det är hälsosamt att motionera dagligen.	Doing daily exercise is a healthy activity.
Jag har inte tillräcklig rörlighet för att spela basket.	I do not have enough agility to play basket.
Det är kallt; du borde sätta på dig något med långa ärmar.	It's cold; you'd better wear something with long sleeves.
Jag skulle hellre vilja få prispengarna kontant.	I'd rather receive the prize in cash.
Avtalet måste skrivas under inom en vecka.	The contract must be signed within a week.
Tjugo personer blev allvarligt skadade.	Twenty people were seriously injured.
Hon tog av sig tofflorna och satte på sig skorna igen.	She took off her slippers and put on her shoes again.
Offren för översvämningen räddades av en helikopter.	The flood victims were rescued by a helicopter.
Barnen gjorde sina teckningar färgglada med färgkritor.	The children made their drawings colorful with crayons.
Vad sägs om ett trevligt parti schack?	How about a nice game of chess?
Jag skulle älska att ha en trädgård på taket.	I would love to have a garden on the roof.
Jag behöver betala kontant. Finns det någon bankomat här?	I need to pay in cash. Is there an ATM here?
Vad är en artesisk brunn?	What is an artesian well?
Min lägenhet ligger på första våningen.	My flat is on the first floor.
Det finns tusen anledningar till att göra det.	There are a thousand reasons to do it.
Vad är en artesisk brunn?	What is an artesian well?
Jag är genomblöt av svett efter att jag sprungit.	I am soaked in sweat after running.
Det här kapitlet är jätteintressant.	This chapter is very interesting.
Jag gillar inte beskt kaffe, jag dricker det hellre med lite socker.	I don't like bitter coffee, I prefer it with a bit of sugar.
Jag tror din mamma slängde det som var kvar av pajen.	I think your mom threw out the rest of the pie.
Jag vill ha den orange markeringspennan, tack.	I want the orange marker, please.
Valrossen har en hink.	The walrus has a bucket.
Hon och hennes kompisar tränar agility med sina hundar.	She and her friends do agility training with their dogs.
Jag är inget helgon.	I'm not a saint.
Hans tillhåll är okänt, men man tror att han flytt landet.	His whereabouts are unknown, but they think he's fled the country.
Tack för ditt stöd.	Thanks for your support.
Jag skulle vilja ha en liten bit tårta, tack.	I would like a small piece of cake, please.
Först visste jag inte vad jag skulle säga.	At first I didn't know what to say.
I Europa råder det brist på bostäder.	In Europe there is housing shortage.
Till slut var jag tvungen att erkänna att han hade rätt.	In the end I had to admit that he was right.
Att skaffa vänner är svårt när man är extremt blyg.	Making friends is hard when you are painfully shy.
En hemlig beundrare har skickat mig blommor!	A secret admirer has sent me flowers!
Hon har inte gått än.	She hasn't gone yet.
Ta av dig de där smutsiga kläderna!	Take those dirty clothes off!
Lågan förstörde det hemliga meddelandet på några sekunder.	The flame destroyed the secret message in seconds.
Ibland känns det som att hela världen är emot mig!	Sometimes it feels like the whole world is against me!
Vi kommer att se saker klarare i dagsljuset.	We'll see things clearly in the cold light of day.
När ska du gifta dig?	When are you getting married?
Jag kommer att älska dig för alltid.	I will love you forever.
Pumpan är den mest köpta grönsaken i oktober.	The pumpkin is the most bought vegetable in October.
Planet avgick för tio minuter sedan. Vad ska vi göra?	The plane took off ten minutes ago. What do we do?
Jag vill lära mig mer svenska.	I want to learn more Swedish.
Ta hissen upp till nionde våningen.	Take the elevator to the ninth floor.
Han spelar piano som en virtuos.	He plays the piano like a virtuoso.
Det är din tur att kasta tärningarna.	It's your turn to roll the dice.
Mars har två månar.	Mars has two moons.
Deras expedition grävde fram antika ruiner.	Their expedition uncovered ancient ruins.
Fläkten svalkar rummet.	The fan will cool the room.
Vilken våghalsig bilförare, som sms:ar!	What a reckless driver - he's texting!
I mörkret satte jag av misstag på mig en marinblå och en svart strumpa.	In the dark I accidentally put on one navy sock and one black.
Det hänger spindelnät från taket.	There are cobwebs hanging from the ceiling.
Det är inte värmen, utan det är fuktigheten.	It's not the heat, it's the humidity.
Jag har ont i bröstet.	My chest hurts.
Du är en sådan lögnare!	You're such a liar!
Jag har inget att förlora.	I have nothing to lose.
Det är jättevarmt härinne.	It's very hot in here.
Allt vi kunde höra var vattenfallets brus.	All we could hear was the roar of the waterfall.
Himlen är mulen.	The sky is overcast.
Man ser inte skogen för bara träd.	You can't see the forest due to the trees.
Det är tillräckligt nu!	Enough already!
Jag har tappat nycklarna igen.	I have lost my keys again.
Det är farligt att cykla utan hjälm.	It's dangerous to bike without a helmet.
Vissa dagar kräver mer kaffe än andra.	Some days require more coffee than others.
Jag älskar att laga mat med vin.	I love to cook with wine.
Min resväska är så tung att jag inte kan bära den.	My suitcase is so heavy I can´t carry it.
Kan någon berätta för mig när vi kommer fram till stationen?	Can someone tell me when we will arrive at the station?
Jag ska köra bil, så jag tar bara ett glas vatten.	I have to drive, so I'll just have a glass of water.
Esmeralda i "Ringaren i Notre Dame" var zigenare.	Esmeralda in "The Hunchback of Notre Dame" was a gypsy.
Det är inte mitt fel.	It is not my fault.
Tror du helvetet är en sådan dålig plats?	Do you think that hell will be such a bad place?
Jungfrun kunde se sin riddare från tornet.	The maiden could see her knight from the tower.
Mitt arbete här är gjort.	My work here is done.
Jag kommer aldrig att släppa dig.	I will never let you go.
Ett leende är det bästa sättet att tacka.	A smile is the best way to say "thank you."
Snälla, stäng dörren, det är kallt ute.	Close the door please, it's cold outside.
Offret hämnades på gärningsmannen.	The victim got revenge on the wrongdoer.
Jag kunde inte dölja min besvikelse när jag hörde nyheterna.	I couldn't hide my disappointment when I heard the news.
Man bör sitta kvar när planet landar.	One should remain seated when the plane lands.
Vi kom fram utan missöden.	We arrived without any mishap.
Oro kan orsaka halsbränna.	Anxiety can cause heartburn.
Glöm inte att spola toaletten.	Don't forget to flush the toilet.
Valet var riggat.	The election was rigged.
Polisen kom sent till rånplatsen.	The police arrived late at the robbery scene.
Skrivaren har slut på papper.	The printer is out of paper.
Publiken applåderade jonglören.	The audience applauded the juggler.
Utredningen avslöjade en skandal.	The investigation revealed a scandal.
Vissa säger att livet är en motorväg.	Some say that life is a highway.
Gärningsmannen dömdes till livstids fängelse.	The criminal was sentenced to life imprisonment.
Efter lunch kan jag inte sluta gäspa.	After lunch, I can't stop yawning.
Vilken dåre, som tror han kan överge mig!	What a fool, thinking he can desert me!
Det är inte tillåtet att ta med nallebjörnar till skolan.	Bringing teddy bears to school is not allowed.
Hon blev berömd för sina gärningar.	She was praised for her deeds.
Mitt hjärta slår tio gånger snabbare när Daniel går förbi.	My heart beats ten times faster when Daniel walks by.
Jag kan inte jobba med de här människorna!	I can't work with these people!
Ta det lugnt, det löser sig.	Take it easy, it'll be okay.
Det är viktigt att kolla på utgångsdatumet varje gång man använder mejeriprodukter.	It is important to look at the expiration date every time you use dairy products.
Under rasten serverades snacks.	During the break, snacks were served.
Sökes: Barnflicka till två barn.	Wanted: Nanny for two kids.
Jag läste det från början till slut två gånger.	I read it from beginning to the end twice.
Att flytta är som att börja om från början.	Moving out is like starting from scratch
Allt hennes mormor gör nuförtiden är att tjata.	All her grandma ever does lately is nag.
Sierskan spådde din framgång.	The fortune teller predicted your success.
Min penna har slut på bläck.	My pen is out of ink.
Jag tolererar inte denna förolämpning!	I will not tolerate this insult!
Språkstudier intresserar mig.	Language studies interest me.
Vi åker till stranden varje år.	We visit the beach every year.
Han kastade en snöboll på mig.	He threw a snowball at me.
Har juryn kommit fram till någon dom?	Has the jury reached a verdict?
Han kan räkna till etthundra på koreanska.	He can count to 100 in Korean.
Vi satt vid eldstaden och smuttade på vårt te.	We sat by the hearth sipping our tea.
Använd hjälm när du cyklar.	Wear your helmet when you ride your bike.
Vi har prinsesstårta i källaren.	We have princess cake in the cellar.
Låt oss nu se vad som finns i lådan. Ingenting! Absolut ingenting!	Now let's see what's in the box. Nothing! Absolutely nothing!
Ingenting är sorgligare än en clowns tårar.	Nothing is sadder than the tears of a clown.
Jag behöver tvåhundra gram (200g) köttfärs.	I need half a pound (200 g) of ground meat.
Min storasyster tog hem godis till oss.	My big sister brought us candy.
Prata inte med honom. Han är på dåligt humör.	Don't talk to him. He's in a bad mood.
Den här soppan behöver lite salt.	This soup could use a little bit of salt.
Jag tycker inte om min granne. Hon lägger sig alltid i.	I don't like my neighbor. She's a meddler.
Var inte kompis med dem. De är förlorare.	Don't be friends with them. They are losers
Trots min motvilja, gick jag med honom.	In spite of my reluctance, I went with him.
Pingvinen följde mig hela vägen till affären.	The penguin followed me all the way to the store.
Jag kan inte tro det. Skämtar du?	I can't believe it. Are you kidding?
Jag åker till stranden lite då och då.	I go to the beach from time to time.
Skydd är ett av tre grundläggande behov.	Shelter is one of three basic needs.
Upproret förde med sig de sociala förändringar som behövdes.	The uprising brought about the needed social changes.
Jag kan inte åka i helgen, jag är i tjänst då.	I can't go this weekend, I am on duty.
Nationen saknade en armé att försvara sig med.	The nation lacked an army to defend itself with.
Explosionen skrämde bort folket.	The explosion frightened the people away.
Den skallige mannens huvudsvål syntes.	The scalp of the bald man was visible.
Politikern blev av med sin motståndare.	The politician got rid of his rival.
Hennes svar var löjliga.	Her replies were ridiculous.
Behåll växeln, vännen.	Keep the change, friend.
Hans nya uppfinning exploderade på bara några minuter.	His new invention exploded within minutes.
Kamma ditt hår i duschen för att spara tid.	Comb your hair in the shower to save time.
Hon uttrycker sig på ett komiskt sätt.	She has a comical way of saying things.
I Sverige är det vanligt att äta pasta med ketchup.	In Sweden it is common to eat pasta with ketchup.
Teknikern ska ansluta kablarna till cd-spelaren.	The technician will connect the cables to the CD player.
Simon är den som underhåller nätverket.	Simon is the one who maintains the network.
Jag funderar på att åka till Ryssland nästa månad.	I'm considering visiting Russia next month.
Bygg inte ditt hus på sand.	Don't build your house on sand.
Alkemisterna lyckades aldrig förvandla bly till guld.	Alchemists never did manage to convert lead into gold.
Hon har varit min flickvän i två månader.	She has been my girlfriend for two months.
Tidningen publicerade en liten rättelse.	The newspaper issued a small correction.
Var passar vi in i det stora kosmiska schemat?	Where do we fit in the grand cosmic scheme?
Barn i USA klär ut sig i maskeraddräkter varje år på Halloween.	Children in the US wear costumes every year on Halloween.
En fin kristallkrona hänger från taket.	A fine crystal chandelier hangs from the ceiling.
Ibland uppstår konflikter genom överlappande arbetsuppgifter.	Sometimes conflicts arise from overlapping job duties.
Våra bröllopsgäster börjar anlända nu!	Our wedding guests are starting to arrive!
Varning för hunden!	Be careful of the dog!
Gå in på min Facebook-profil.	Visit my Facebook profile.
Det var verkligen roligt att prata med dig.	It's been a pleasure chatting with you.
Inga nyheter är bra nyheter.	No news is good news.
Gentlemannen tog av sig sina handskar och cylinderhatt.	The gentleman took off his gloves and top hat.
När jag har en dålig dag, ser jag till att alla mina Facebook-vänner får veta det!	When I have a bad day, I make sure all my Facebook friends know!
Det är så roligt att se barn öppna sina julklappar.	It's so funny to see children opening their Christmas gifts.
Vi kommer att träffas igen i livet efter detta.	We'll meet again in the afterlife.
Får jag använda din pennvässare?	Can you lend me your pencil sharpener?
Vi måste fortsätta kämpa för mänskliga rättigheter.	We have to keep on fighting for human rights.
Han satte sig ner och lossade på slipsen.	He sat down and loosened his tie.
Han var bländad av kvinnans skönhet.	He was dazzled by woman's beauty.
Jag gillar fisk tillagad på grillen.	I like fish cooked on the grill.
Polisen hittade inte gärningsmannen i träsken, men det gjorde insekterna.	The police didn't find the convict in the swamp, but the bugs did.
Jag saknar all fritid jag hade under min barndom.	I miss all the free time I had in my childhood.
Vad sa du? Förlåt, jag var försjunken i tankar.	What did you say? I'm sorry, I was lost in thought.
Jag låter inte min framtid avgöras av slumpen.	I will not leave my future up to chance.
Jag är tokig i den här låten!	I'm crazy about this song!
Han dissade mig!	Han stood me up!
Sanningen finns därute.	The truth is out there.
Vi behöver prata om våra känslor.	We need to talk about our feelings.
Ditt hår ser bra ut idag.	Your hair looks good today.
Ge dig iväg från min fruktträdgård, annars så skickar jag hundarna på dig!	Get out of my orchard or I'll set the dogs on you!
Jag har en passion för fotografering.	I am passionate about photography.
Jag gillar inte att ha vita kläder på mig.	I don't like to wear white clothes.
Jag har nya sandaler.	I have new sandals.
Är det här din son? Vad söt!	Is this your son? How cute!
Den fula ankungen växte upp till att bli en vacker svan.	The ugly duckling grew up to be a beautiful swan.
Bilen startar inte.	The car won't start.
Hur häftigt är inte det!	How cool is that!
Om jag inte använder hårtork för att torka håret, ser det inte bra ut.	If I don't use a hairdryer my hair won't look good.
Du ser fin ut i den klänningen.	You look beautiful in that dress.
Köp två, få en gratis.	Buy two, get one free.
Jag har några förslag.	I have some suggestions.
Jag har jobbat hela dagen; jag är slutkörd.	I've worked all day long; I'm exhausted.
Tack för din hjälp; du är en ängel.	Thank you for your help; you're an angel.
Stackarn började gråta bittert.	The poor thing started to cry bitterly.
Det är ett rent elände att bo med min svärmor.	It's a misery living with my mother-in-law.
Vad heter du?	What's your name?
Trevligt att träffas.	It is a pleasure to meet you.
Det var jättegott.	That was delicious.
Varifrån kommer du?	Where are you from?
Jag pratar lite hindi.	I speak a little Hindi.
Det är inte första gången, och kommer inte heller vara den sista.	It's not the first time, and won't be the last.
Jag ber om ursäkt, jag har en dålig dag.	I apologize, I'm having a bad day.
Jag går till affären; vill du följa med?	I'm going to the store, want to go with me?
Dadlarna är jättegoda, men jag föredrar ananas.	The dates are delicious, but I prefer pineapple.
Jag är så glad att imorgon är fredag; det har varit en lång vecka!	I'm so glad tomorrow is Friday; it's been a long week!
Har du några planer för helgen?	Do you have any plans for this weekend?
Hur ser vädret för imorgon ut?	What's the weather prediction for tomorrow?
Det ska regna, ta med ett paraply.	It's going to rain, bring an umbrella.
Barnen gillar att leka utomhus.	The children like to play outside.
Det här är en av mina favoritlåtar.	This is one of my favorite songs.
Han glömmer aldrig att tacka.	He never forgets to say thank you.
Såg du meteorregnet igår? Helt fantastiskt!	Did you see the meteor shower last night? Amazing!
Var ligger den närmaste marknaden?	Where is the nearest market?
Om du är arg, ta ett djupt andetag och räkna till tio.	If you're angry, take a deep breath and count to ten.
Kamouflage är naturens bästa knep.	Camouflage is nature's best trick.
Om jag berättar för dig, kommer det inte att vara en hemlighet längre!	If I tell you, it won't be a secret anymore!
Internet har förändrat våra liv, på gott och på ont.	The internet has changed our lives, for good or bad.
Sitt upp! Dålig hållning leder till senare ryggproblem.	Sit up! Bad posture will lead to back problems later on.
Gör inte det! Det är en dålig idé!	Don't do that! It's a bad idea!
Om vi inte skyndar oss, kommer vi att missa bussen.	If we don't hurry, we'll miss the bus.
Hej allihopa! Förlåt att jag är sen.	Hi everyone! Sorry I'm late.
Du kan inte skylla dina problem på andra.	You can't blame other people for your problems.
Trädgårdar behöver bra jordmån, sol, och regelbunden vattning.	Gardens need good soil, sun, and regular watering.
Hur många veckor ska det här projektet ta?	How many weeks does this project have to take?
Den högröstade minoriteten representerar inte majoriteten i de flesta fallen.	The vocal minority do not represent the majority in most cases.
Jag förstår inte. Kan du upprepa det?	I don't understand. Can you repeat that?
Hur vågar du använda sådant språk i det här huset?!	How dare you use such language in this house?!
Ett verb är ett ord som uttrycker en handling eller ett skeende.	A verb is an word that expresses action or occurrence.
Vad fan har du på dig?!	What the heck are you wearing?!
På höga höjder finns det mindre syre i luften.	At high elevations, there is less oxygen in the air.
Jag lärde mig det genom att kolla på dig, Pappa!	I learned it from watching you, Dad!
Klockan är tio. Vet du var dina barn är?	It's 10 o'clock. Do you know where your kids are?
Kostnaderna är höga och intäkterna låga. Vad kan man göra?	Costs are up, revenue is down. What can you do?
Valar och delfiner är däggdjur.	Whales and dolphins are mammals.
Jorden är täckt mest av vatten.	The Earth is covered mostly by water.
Rädslan för att flytta eller att genomgå förändring kallas tropofobi.	The fear of moving or making changes is called tropophobia.
Om Sfinxen ställer en gåta, är det bäst att du vet svaret.	If the Sphinx asks you a riddle, you better know the answer.
Jag har ätit så mycket att jag knappt kan knäppa byxorna!	I ate so much I can barely button my pants!
Han samlar på affischer av gamla skräckfilmer.	He collects posters of old horror movies.
Vi uppträdde på vår lokala teater.	We performed in our community theater.
En expert kan stämma en violin på gehör.	An expert can tune a violin by ear.
Varje höst börjar ett nytt läsår.	Every fall, the school year begins anew.
Du har mycket att lära dig, gräshoppan.	You have much to learn, grasshopper.
Min farfar kan hundratals anekdoter.	My grandfather knows hundreds of anecdotes.
Igår kungjorde de sin förlovning.	Yesterday they announced their engagement.
Två bullriga gäss bor nära dammen.	Two noisy geese live near the pond.
Problemet med silver är att det oxiderar så lätt.	The problem with silver is that it tarnishes so easily.
Fyrverkerier lyste upp kvällshimlen.	Fireworks lit the night sky.
Var parkerade du bilen.	Where did you park the car?
Det är nyttigt med bananer.	Bananas are good for you.
Räck mig kikaren, är du snäll.	Please pass me the binoculars.
Att stirra in i solen orsakar blindhet!	Staring at the sun causes blindness!
Jag värmer vatten i vattenkokaren.	I'm warming water in the kettle.
Dina stövlar står framför dörren.	Your boots are in front of the door.
Räkna tegelstenarna i väggen om du har tråkigt.	Count the bricks in the wall if you're bored.
Hon behöver borsta håret.	She needs to brush her hair.
Vi brände maten av misstag.	We accidentally burned the food.
Deras hästar bor i stallet.	Their horses live in the stable.
Ta med er champagne, vi står för jordgubbarna.	Bring champagne, we'll supply the strawberries.
Jag medger att det är ett attraktivt erbjudande.	I admit, it is an attractive offer.
Vår chef behandlar oss artigt.	Our boss treats us courteously.
Jag tittade, och framför mig stod en blek häst!	I looked, and before me was a pale horse!
De säljer söt äppelcider.	They sell sweet apple cider.
Jag gjorde ett fotoalbum från vår senaste semester.	I made a photo album of our last vacation.
Cigarrer är en av Kubas största exportvaror.	Cigars are one of Cuba's largest exports.
Den unga flickan kramade om sin nallebjörn.	The young girl hugged her teddy bear.
Kan du recitera den gamla dikten?	Can you recite the old poem?
Snälla svara på frågan ärligt.	Please answer the question honestly.
Jag har varit hos tandläkaren tusen gånger, så jag vet hur det går till.	I've been to the dentist a thousand times, so I know the drill.
Konstnären ritade en utmärkt figur.	The artist drew an excellent figure.
Skada inte paketet.	Do not damage the package.
Vilken skillnad en dag kan göra!	What a difference a day makes!
Då delar vi upp tårtan i lika stora bitar.	Let's divide the cake into equal parts.
Vad gav du henne i födelsedagspresent?	What did you give her for her birthday?
Jag tvivlar på att måtten är precisa.	I doubt the accuracy of the measurements.
Du kan duscha i badrummet på övervåningen.	You can shower in the bathroom upstairs.
Förklara lösningen för mig en gång till.	Explain the solution to me one more time.
Våra traditioner måste verka främmande för dig.	Our customs must seem alien to you.
Kan du ge mig ett exempel på vad du menar?	Can you give me an example of what you mean?
Vilket kort ska jag välja?	Which card should I choose?
Efter en lång promenad, är hennes hund energisk.	Even after a long walk, her puppy is energetic.
Hans fall handlade om misstagen identitet.	His was a case of mistaken identity.
Det finns undantag till varje regel.	There are exceptions to every rule.
Det sägs att spöken hemsöker det gamla huset.	They say that ghosts haunt the old house.
Har du läst ut boken?	Have you finished the book?
Vilken kylig dag!	What a chilly day!
Vi väntar på bussen.	We are waiting for the bus.
Barnen åker skridskor på dammen när den är helt fryst.	The children ice-skate on the pond once it is frozen solid.
Hans morfar gav honom en pulka i vintras.	His grandfather gave him a sled last winter.
Min hals gör ont idag.	My throat is hurting today.
Min bror tar studenten om en månad.	My brother will graduate in a month.
Gräsklipparen behöver bensin.	The lawnmower needs gasoline.
Det fanns en grön äng nedanför klippan.	There was a green meadow below the cliff.
De studerade historia vid universitetet.	They studied history at the university.
För trettio år sedan slog blixten ner i det där klocktornet.	Thirty years ago, lightning struck that clock tower.
Hur kommer man till sjukhuset?	Which way is the hospital?
Man ska inte strunta i sina kompisar.	You shouldn't ignore your friends.
Vad tror du talet innebär?	What do you think the speech implied?
Glöm inte att betala skatt!	Do not forget to pay your taxes!
Skådespelarna improviserade hela scenen.	The actors improvised the entire scene.
Hennes hem är fint inrett, som vanligt.	Her house is, as usual, very well decorated.
Du kommer att behöva en större båt.	You're going to need a bigger boat.
Meddelandet har kanske råkat hamna i din mapp för skräppost.	The email may have accidentally gone into your junk mail folder.
Varför blockerade du mig på Twitter, vännen?	Why'd you block me on Twitter, friend?
Tålamod är en dygd.	Patience is a virtue.
Jag vågar inte fråga henne en tredje gång.	I don't dare to ask her a third time.
Jag har varit uppe hela natten och pluggat inför det här provet.	I've been up all night studying for this test.
Skruva ner volymen, jag får huvudvärk	Turn down the volume, I'm getting a headache.
Om löken är för stor, använd bara halva.	If the onion is too big, use only half of it.
Vill du ha pommes frites till?	Do you want fries with that?
Hon och jag ska gå till stranden imorgon.	She and I will go to the beach tomorrow.
Såg skogsmurmeldjuret sin skugga?	Did the groundhog see his shadow?
Vill du fotvandra genom skogen?	Do you want to hike through the woods?
Jag fick aldrig bra betyg i matematik.	I never received good grades in mathematics.
En bilmekaniker reparerade vår bil.	A mechanic fixed our car.
Du har ett öppet sinne.	You have an open mind.
Jag kan inte bestämma mig. Ska vi singla slant?	I can't make up my mind. Shall we flip a coin?
Ingen verkar ha tillräckligt med pengar.	Nobody seems to have enough money.
Min hund kommer inte att bita dig.	My dog will not bite you.
Myggorna vill inte lämna mig i fred!	The mosquitoes will not leave me alone!
Vem är din favoritfilmstjärna?	Who's your favorite movie star?
Jag älskar skaldjur men min kompis är allergisk mot det.	I love seafood, but my friend is allergic to it.
Ibland gillar jag att bara sätta mig med en bra bok.	Sometimes I just like to sit down with a good book.
Bort från min gräsmatta!	Get off my lawn!
Det är lättare att be om förlåtelse än om tillåtelse.	It's easier to ask forgiveness than permission.
Min granne är gift med sin syssling.	My neighbor married her second cousin.
Hennes hår ser jättebra ut i flätor.	Her hair looks really good in braids.
Du kompletterar mig.	You complete me.
Fordonets passagerare blev inte skadad.	The passenger of the vehicle was unharmed.
Idag hade museet en intressant utställning om indisk folkmusik.	The museum had an interesting exhibit about Indian folk music today.
Få inte panik, det är bara en brandövning.	Don't panic, it's only a fire drill.
När hon såg mig, pussade hon mig två gånger på kinderna.	When she saw me, she kissed me twice on the cheeks.
Man ska dricka mycket vatten när man är förstoppad.	You have to drink a lot of water when you're constipated.
Annika föredrar fläsk framför nötkött.	Annika prefers pork to beef.
I natt drömde jag att jag flöt bland molnen.	Last night I dreamt I was floating amongst the clouds.
Branden spreds inte eftersom sprinklerna var aktiverade.	The fire did not spread because the sprinklers were activated.
Under vår resa runt i England, besökte vi klipporna i Dover.	During our trip around England we visited the cliffs of Dover.
Ska vi vila bredvid den där busken därborta?	Should we rest beside that bush over there?
Ring mig ikväll, så gör vi planer.	Call me tonight and we'll make plans.
Kvinnan på flygplatsen kontrollerade våra boardingkort.	The woman at the airport checked for our boarding passes.
Låt mig ge dig ett tips.	Let me give you a hint.
Programmet har ett lättanvänt gränssnitt.	The program has an easy-to-use user interface.
Nästa år är ett skottår.	Next year is a leap year.
Såg du rubrikerna i morse?	Did you see the headlines this morning?
Ni ska lämna in era rapporter på måndag morgon.	You are to hand in your reports on Monday morning.
Vintersnön har redan smält.	The winter snow has already melted.
Första utkastet är färdigt imorgon.	The first draft will be ready by tomorrow.
Det kryper en tusenfoting i badkaret!	There is a centipede in the bathtub!
Man måste tina upp kalkonen innan man lägger in den i ugnen.	You have to defrost the turkey before putting it in the oven.
Min farbror har en segelbåt ute på sjön.	My uncle has a sailboat out on the lake.
Jag håller med dig om det.	I agree with you on that issue.
